%%%%%%%%%%%%%%%%%%%
%........P........%
%.................%
%....%%%%%%%%%....%
%.................%
%.o.............o.%
%.................%
%....%%%%%%%%%....%
%.................%
%........G........%
%%%%%%%%%%%%%%%%%%%