%%%%%%%%%%%%%%%%%%%
%........P........%
%.................%
%.................%
%.................%
%.o.....%%%.....o.%
%.................%
%.................%
%.................%
%........G........%
%%%%%%%%%%%%%%%%%%%