%%%%%%%%%%%%%%%%%%%
%.................%
%........%........%
%........%........%
%........%........%
%P...o...%...o...G%
%........%........%
%........%........%
%........%........%
%.................%
%%%%%%%%%%%%%%%%%%%