%%%%%%%%%%%%%%%%%%%
%...%........%...P%
%.G.%.%%%%%%.%.%%.%
%...%.%....%.%....%
%.%.%.%.%G.%.%.%%.%
%.%...%.%%%%.%....%
%.%...%o.....%.%%.%
%.%...%%%%%%%%....%
%.%%%%%.........G.%
%.........o.......%
%%%%%%%%%%%%%%%%%%%