%%%%%%%%%%%%%%%%%%%
%.G%...........%G.%
%..%.%%%%%%%%%.%..%
%...o%.......%o...%
%.%%%%.%%%%%.%%%%.%
%.................%
%.%%.%%%%.%%%%.%%.%
%....%.......%....%
%.%%.%.%%%%%.%.%%.%
%.P..%.......%..G.%
%%%%%%%%%%%%%%%%%%%