%%%%%%%%%%%%%%%%%%%
%.....%..G..%.....%
%.%G%.%.%.%.%.%G%.%
%.....%.....%.....%
%.%.%...%.%...%.%.%
%..o...........o..%
%.%.%...%.%...%.%.%
%.....%.....%.....%
%.%.%.%.%.%.%.%.%.%
%.....%..P..%.....%
%%%%%%%%%%%%%%%%%%%