%%%%%%%%%%%%%%%%%%%
%..P..%..G..%..o..%
%.%%%.%.%%%.%.%%%.%
%.....%..%..%.....%
%.%%%%%..%..%%%%%.%
%..o..%..%..%.....%
%.%%%.%.%%%.%.%%%.%
%.....%..%..%.....%
%.%%%%%..%..%%%%%.%
%..G.....%.....G..%
%%%%%%%%%%%%%%%%%%%