%%%%%%%%%%%%%%%%%%%
%o.......G.......o%
%.%.%.%.%.%.%.%.%.%
%.................%
%.%.%.%.%.%.%.%.%.%
%........P........%
%.%.%.%.%.%.%.%.%.%
%.................%
%.%.%.%.%.%.%.%.%.%
%G...............G%
%%%%%%%%%%%%%%%%%%%