%%%%%%%%%%%%%%%%%%%
%.G%.....o.....%G.%
%....%%%%%%%%%....%
%....%.......%....%
%.%%%%.%%%%%.%%%%.%
%.................%
%.%%.%%%...%%%.%%.%
%....%.......%....%
%.%%.%.%%%%%.%.%%.%
%...P%...o...%G...%
%%%%%%%%%%%%%%%%%%%