%%%%%%%%%%%%%%%%%%%
%.....%.....%.....%
%.%G%.%.%o%.%.%.%.%
%.....%.....%.....%
%.%.%.%.%.%.%.%.%.%
%........P........%
%.%.%.%.%.%.%.%.%.%
%.....%.....%.....%
%.%G%.%.%o%.%.%G%.%
%.....%.....%.....%
%%%%%%%%%%%%%%%%%%%