%%%%%%%%%%%%%%%%%%%
%.................%
%.%%%..%.%.%..%%%.%
%.%....%.%.%o...%.%
%....%%%.%.%%%....%
%...G....%....G...%
%....%%%.%.%%%....%
%.%...o%.%.%....%.%
%.%%%..%.%.%..%%%.%
%........P........%
%%%%%%%%%%%%%%%%%%%