%%%%%%%%%%%%%%%%%%%
%..Go.........%...%
%.%.%..%%.%%..%.%.%
%...%..%...%..%...%
%.%.%..%.%.%..%.%.%
%...%..%...%..%...%
%.%.%..%.%.%..%.%.%
%...%..%...%..%...%
%.%.%..%%.%%..%.%.%
%P..%.........oG..%
%%%%%%%%%%%%%%%%%%%