%%%%%%%%%%%%%%%%%%%
%.....%.......%...%
%.%%%..%%%%%%..%%.%
%...%..%....%..%..%
%.%.%..%..% %..%.%%
%...%..%..% %..%..%
%.%%%..%..%%%..%%.%
%.....%.......%...%
%.%%%%%%%%%%%%%.%.%
%P.............%G.%
%%%%%%%%%%%%%%%%%%%