%%%%%%%%%%%%%%%%%%%
%..G..%.......%...%
%.%%%..%.%%%..%.%.%
%...%..%...%..%...%
%.%.%..%.%.%..%.%.%
%...%..%...%..%...%
%.%.%..%.%.%..%.%.%
%...%..%...%..%...%
%.%..%%%.%%%..%.%.%
%P..%.......%..G..%
%%%%%%%%%%%%%%%%%%%