%%%%%%%%%%%%%%%%%%%
%.......%.........%
%.%%%%%.%.%%%%%.%.%
%.....%...%.....%.%
%.%%%.%%%%%.%%%.%.%
%...%...%...%...%..%
%.%.%%%.%.%%%.%.%.%
%...%.....%...%....%
%.%%%%%.%.%%%%%.%.%
%P......%.......G.%
%%%%%%%%%%%%%%%%%%%