%%%%%%%%%%%%%%%%%%%
%.G%....%....%..G.%
%..%.%%%.%%%%.%%%.%
%....%.......%....%
%.%%%%.%%%%%.%%%%.%
%....%...%...%....%
%.%%%.%%% %%%.%%%.%
%....%...%...%....%
%.%%%%.%%%%%.%%%%.%
%P...%.......%..G.%
%%%%%%%%%%%%%%%%%%%