%%%%%%%%%%%%%%%%%%%
%..%.....%.....%..%
%..%.%%%.%.%%%.%..%
%....%...%...%....%
%.%%%%.%%%%%.%%%%.%
%....%...%...%....%
%..%.%%%.%.%%%.%..%
%..%.....%.....%..%
%.%%%%.%%%%%.%%%%.%
%P...%...%...%..G.%
%%%%%%%%%%%%%%%%%%%