%%%%%%%%%%%%%%%%%%%
%.....%.....%.....%
%.%%%..%.%.%..%%%.%
%...%..%...%..%...%
%.%.%..%%.%%..%.%.%
%...%.....%.....%G%
%.%.%%%.%%%%.%%%.%%
%.....%.....%.....%
%.%%%..%.%.%..%%%.%
%P....%.....%.....%
%%%%%%%%%%%%%%%%%%%