%%%%%%%%%%%%%%%%%%%
%.....%.....%.....%
%.%%%..%%%..%%%..%.%
%...%.....%.....%..%
%.%.%%%%%.%%%%%.%.%
%.....%.....%.....%
%.%.%%%%%.%%%%%.%.%
%..%.....%.....%...%
%.%..%%%..%%%..%%%.%
%P....%.....%....G%
%%%%%%%%%%%%%%%%%%%