%%%%%%%%%%%%%%%%%%%
%.......%.........%
%.%%%...%...%%%...%
%...%.......%.....%
%...%%%%.%%%%...%.%
%.......%.........%
%.%.%%%%%.%%%%%.%.%
%.........%.......%
%...%%%...%...%%%..%
%P.............G..%
%%%%%%%%%%%%%%%%%%%