%%%%%%%%%%%%%%%%%%%
%.................%
%.......%.........%
%.......%.........%
%.......%.........%
%.......%.........%
%P.o....%.....G...%
%.......%.........%
%.......%.........%
%.................%
%%%%%%%%%%%%%%%%%%%