%%%%%%%%%%%%%%%%%%%
%........%........%
%.%%%%%..%..%%%%%.%
%.....%..%..%.....%
%..%%.%..%..%.%%..%
%..%..%.....%..%..%
%P.%..%%%%.%%%%..G%
%..%.....%..%.....%
%.%%%%%..%..%%%%%.%
%........%........%
%%%%%%%%%%%%%%%%%%%