%%%%%%%%%%%%%%%%%%%
%.................%
%..%%%%%..%%%%%...%
%..%.........%....%
%..%..%%%%%..%....%
%..%..%...%..%....%
%P....%...%....G..%
%..%..%...%..%....%
%..%..%%%%%..%....%
%..%.........%....%
%%%%%%%%%%%%%%%%%%%