%%%%%%%%%%%%%%%%%%%
%.......%%%.......%
%..%%%..% %..%%%..%
%..%....% %....%..%
%..%.%%%% %%%%.%..%
%.....%       %...%
%..%.%%%% %%%%.%..%
%..%....% %....%..%
%..%%%..% %..%%%..%
%P......%%%.....G.%
%%%%%%%%%%%%%%%%%%%