%%%%%%%%%%%%%%%%%%%
%..%..%..%..%..%..%
%.%.%.%.%.%.%.%.%.%
%..%..%..%..%..%..%
%.%.%.%.%.%.%.%.%.%
%..%..%..%..%..%..%
%.%.%.%.%.%.%.%.%.%
%..%..%..%..%..%..%
%.%.%.%.%.%.%.%.%.%
%P.%..%..%..%..%.G%
%%%%%%%%%%%%%%%%%%%