%%%%%%%%%%%%%%%%%%%
%.......%.........%
%.......%.........%
%.......%.........%
%.......%.........%
%.......%.........%
%P......%.....G...%
%.......%.........%
%.......%.........%
%.......%.........%
%%%%%%%%%%%%%%%%%%%