%%%%%%%%%%%%%%%%%%%
%.....%.....%.....%
%.%%%.%.%%%.%.%%%.%
%.....%..%..%.....%
%.%%%%%..%..%%%%%.%
%.....%..%..%.....%
%.%%%.%.%%%%%.%%%.%
%.....%..%..%.....%
%.%%%%%..%..%%%%%.%
%P....%..%..%....G%
%%%%%%%%%%%%%%%%%%%